14 14 14 14 14 14 14 14 14 14 14 14 14 14 14 14 14 14 14 14 14 14 14 14 14 14 14 14 14 14 14 14 14 14 14 14 14 14 14 14 14 14 14 14 14 14 14 14 14 14 14 14 14 14 14 14 14 14 14 14 14 14 14 14 
14 0 0 0 0 0 0 0 0 0 0 0 0 0 0 0 0 0 0 0 0 0 0 0 0 0 0 0 0 0 0 0 0 0 0 0 0 0 0 0 0 0 0 0 0 0 0 0 0 0 0 0 0 0 0 0 0 0 0 0 0 0 0 14 
14 11 11 11 11 11 11 11 11 11 11 11 11 11 11 11 11 11 11 11 11 11 11 11 11 11 11 11 11 11 11 11 11 11 11 11 11 11 11 11 11 11 11 11 11 11 11 11 11 11 11 11 11 11 11 11 11 11 11 11 11 11 0 14 
14 0 0 0 0 0 0 0 0 0 0 0 0 0 0 0 0 0 0 0 0 0 0 0 0 0 0 0 0 0 0 0 0 0 0 0 0 0 0 0 0 0 0 0 0 0 0 0 0 0 0 0 0 0 0 0 0 0 0 0 0 0 0 14 
14 0 1 1 1 1 1 1 1 1 1 1 1 1 1 1 1 1 1 1 1 1 1 1 1 1 1 1 1 1 1 1 1 1 1 1 1 1 1 1 1 1 1 1 1 1 1 1 1 1 1 1 1 1 1 1 1 1 1 1 1 1 1 14 
14 0 0 0 0 0 0 0 0 0 0 0 0 0 0 0 0 0 0 0 0 0 0 0 0 0 0 0 0 0 9 0 0 0 9 0 0 0 9 0 0 0 9 9 0 0 0 9 0 0 0 9 0 0 0 9 0 0 0 9 0 0 0 14 
14 0 3 3 3 3 3 3 3 3 0 2 2 2 2 2 0 4 4 4 4 4 4 1 1 1 0 9 9 0 0 0 9 0 0 0 9 0 0 0 9 0 0 0 0 9 0 0 0 9 0 0 0 9 0 0 0 9 0 0 0 9 0 14 
14 0 3 0 0 0 5 0 0 0 0 5 0 4 0 0 0 5 0 0 0 2 0 0 0 0 1 0 0 0 3 3 3 3 3 3 3 3 3 3 3 3 3 3 3 3 3 3 3 3 3 3 3 3 3 3 3 3 3 3 3 3 3 14 
14 0 3 0 6 0 5 0 5 5 0 5 0 4 0 4 0 5 0 7 0 0 0 2 0 0 0 1 2 0 0 0 0 7 7 0 0 0 0 0 8 0 0 0 0 0 0 0 0 0 0 0 0 0 0 0 0 0 0 0 0 0 0 14 
14 0 3 0 6 0 5 0 5 5 5 5 0 4 0 4 0 5 0 7 7 7 7 7 7 2 0 0 2 2 0 5 0 0 7 7 0 0 8 0 8 0 8 8 8 0 6 4 4 4 4 4 4 4 4 4 4 4 4 4 4 4 0 14 
14 0 0 0 6 0 0 0 5 0 11 0 0 0 0 4 0 0 0 7 0 0 0 7 0 2 2 0 0 2 0 5 7 0 0 7 7 0 8 0 0 8 0 0 8 0 6 0 0 0 0 0 0 0 4 0 0 0 0 4 0 0 0 14 
14 0 6 6 6 6 5 5 5 0 11 3 3 3 3 3 3 3 0 7 0 7 0 10 0 0 2 2 0 2 0 5 7 7 0 0 7 0 0 8 0 0 8 0 8 0 6 0 0 0 0 4 0 0 0 0 0 4 0 0 0 0 0 14 
14 0 6 0 0 0 3 0 0 0 11 0 0 0 0 0 0 3 0 7 0 7 0 10 10 0 0 2 0 2 0 5 2 0 7 0 0 7 0 0 8 0 0 0 8 0 6 0 4 4 4 4 4 4 4 4 4 4 4 4 4 4 4 14 
14 0 6 0 3 0 3 0 11 0 11 0 4 4 4 4 0 3 0 7 0 7 0 0 10 0 2 0 0 2 0 5 0 0 0 7 0 0 7 0 0 8 0 0 8 0 6 0 0 0 0 0 0 0 0 0 0 0 0 0 0 0 0 14 
14 0 6 0 3 0 3 0 11 0 11 0 0 0 4 0 0 3 0 7 0 7 7 0 10 0 0 0 2 2 0 5 0 7 0 0 7 0 0 7 0 0 8 0 8 0 6 3 3 3 3 3 3 3 3 3 3 3 3 3 3 3 0 14 
14 0 0 0 3 0 3 0 11 0 11 0 8 0 4 0 2 3 0 7 0 0 7 0 10 0 4 2 2 0 0 5 0 7 0 0 0 7 0 0 7 0 0 8 0 0 6 0 0 0 0 0 0 0 0 0 0 0 0 0 0 0 0 14 
14 3 3 3 3 0 3 0 11 0 11 0 8 0 4 0 2 0 0 7 7 0 7 0 10 0 2 2 0 0 5 5 7 7 7 7 0 0 7 0 0 7 0 0 8 0 6 0 3 3 3 3 3 3 3 3 3 3 3 0 3 3 3 14 
14 0 0 0 0 0 5 0 11 0 11 0 8 0 4 0 2 0 7 7 0 0 7 0 10 0 12 0 0 5 5 0 0 0 0 0 7 0 0 7 0 0 7 0 0 8 6 0 0 0 0 0 0 0 0 0 0 0 0 0 0 0 0 14 
14 0 5 5 5 5 5 0 11 0 11 0 8 0 4 0 2 0 0 0 0 7 7 0 10 0 12 0 5 5 0 0 2 0 2 0 0 7 0 0 7 0 0 7 0 0 6 4 4 4 4 4 4 4 4 4 4 4 4 4 4 4 0 14 
14 0 0 0 0 0 0 0 11 0 11 0 8 0 4 0 2 0 7 7 7 7 0 0 10 0 12 0 5 0 0 2 0 2 0 2 0 0 7 0 0 7 0 0 7 0 6 0 0 0 0 0 0 0 0 0 0 0 0 0 0 0 0 14 
14 7 7 7 7 7 7 7 11 0 11 0 8 0 4 0 2 0 0 0 0 0 0 10 10 0 12 0 5 5 0 2 0 2 0 0 2 0 0 7 0 0 0 7 0 0 6 0 4 4 4 4 4 0 4 4 4 4 4 0 4 4 4 14 
14 0 0 0 0 0 0 0 0 0 11 0 8 0 4 0 2 10 10 10 10 10 10 10 0 0 12 0 0 5 0 2 0 0 0 2 0 0 2 0 0 7 0 0 7 0 6 0 0 0 0 0 0 0 0 0 0 0 0 0 0 0 0 14 
14 0 6 6 6 6 6 6 6 6 6 0 8 0 4 0 2 0 0 0 0 0 0 0 0 12 12 12 0 5 0 0 0 0 2 0 0 2 0 0 7 0 0 7 0 0 6 3 3 3 3 3 3 3 3 3 3 3 3 3 3 3 0 14 
14 0 0 0 0 0 0 0 0 0 0 0 0 0 0 0 2 0 12 12 12 0 12 12 0 12 0 12 0 5 0 2 2 2 2 2 0 0 0 7 0 0 7 0 0 0 6 0 0 0 0 0 0 0 0 0 0 0 0 0 0 0 0 14 
14 8 8 8 8 8 8 8 8 8 8 8 8 8 2 2 2 0 0 0 12 0 0 12 0 3 0 12 0 5 0 0 0 0 0 0 2 0 7 0 0 7 0 0 6 0 6 0 6 6 6 6 6 6 6 6 6 6 6 6 6 6 6 14 
14 0 5 0 0 0 5 0 0 0 5 0 0 0 5 0 12 12 12 0 12 12 0 12 3 0 0 12 0 5 8 8 0 8 8 0 0 7 0 0 7 0 0 6 0 0 6 0 0 0 0 0 0 7 7 0 0 0 0 0 0 0 0 14 
14 0 0 0 5 0 0 0 5 0 0 0 5 0 0 0 0 0 6 0 0 12 0 12 12 12 0 12 0 5 0 8 8 0 0 0 7 0 0 7 0 0 6 0 0 0 6 7 7 7 7 7 0 7 7 0 7 7 7 7 7 7 0 14 
14 0 4 4 4 4 4 4 4 4 4 4 14 14 14 14 14 14 6 0 6 12 0 0 0 0 0 12 0 5 0 0 0 0 8 7 0 0 7 0 0 6 0 0 7 0 6 0 0 0 0 0 0 0 0 0 0 0 0 0 0 0 0 14 
14 0 0 0 5 0 0 0 5 0 0 0 5 0 0 0 0 0 6 0 6 12 0 12 12 12 12 12 0 5 0 8 8 8 0 7 0 7 0 0 6 0 0 7 7 0 6 0 5 5 5 5 5 5 5 5 5 5 5 5 5 5 5 14 
14 0 5 0 0 0 5 0 0 0 5 0 0 0 5 0 13 0 0 0 0 0 0 13 0 0 0 0 0 5 0 0 0 0 0 0 7 0 0 6 0 0 7 7 0 0 6 0 0 7 0 0 0 7 0 0 0 5 0 0 0 5 0 14 
14 8 8 8 8 8 8 8 8 8 8 8 8 8 8 0 13 0 13 13 13 13 13 13 0 5 5 5 5 5 0 6 6 6 6 0 0 0 6 0 0 7 7 0 0 7 6 7 0 0 0 7 0 0 0 7 0 0 0 7 0 0 0 14 
14 6 0 0 0 6 0 0 0 6 9 0 0 0 9 0 13 0 11 0 0 0 0 0 0 5 0 0 0 0 0 6 0 0 4 4 4 4 4 4 4 4 4 4 4 4 4 4 4 4 4 4 4 4 4 4 4 4 4 4 4 4 4 14 
14 0 0 6 0 0 0 6 0 0 9 0 9 0 9 0 13 0 11 0 5 5 5 5 5 5 0 6 6 6 6 6 0 9 0 9 8 0 0 0 8 0 0 0 0 0 8 0 8 0 0 0 0 0 0 0 0 0 0 0 0 0 0 14 
14 0 7 7 7 7 7 7 7 7 9 0 9 0 9 0 11 0 11 0 5 5 5 0 0 0 0 0 0 12 0 0 0 0 0 9 0 0 8 0 0 0 8 0 8 0 0 0 0 0 8 0 0 10 0 10 0 10 0 10 0 10 0 14 
14 0 0 0 0 0 0 0 0 0 0 0 9 0 0 0 11 0 11 0 0 0 5 0 6 6 6 6 0 12 0 9 9 0 9 9 5 5 5 0 5 5 5 0 5 5 5 0 5 5 5 0 10 0 0 0 0 0 0 0 0 0 0 14 
14 11 11 11 11 11 11 11 11 11 11 11 11 11 11 11 11 0 11 7 7 0 5 0 0 0 0 0 0 12 0 0 9 0 8 0 0 8 0 0 0 8 0 0 0 8 8 0 0 8 0 0 10 0 10 0 10 0 10 0 10 0 10 14 
14 0 7 0 0 0 11 0 0 0 0 0 0 0 0 0 0 0 0 0 7 0 5 0 6 6 6 6 0 12 0 9 9 0 0 0 0 0 0 8 0 0 0 0 0 0 8 10 0 0 0 10 0 10 0 0 10 0 0 0 0 0 0 14 
14 0 0 0 7 0 11 0 8 8 8 8 0 7 0 11 11 11 11 0 7 0 5 0 0 0 0 0 0 12 0 0 9 0 5 5 5 5 0 5 5 5 0 5 8 0 8 0 0 10 0 10 0 10 0 10 0 10 0 10 0 10 0 14 
14 10 10 10 10 0 11 0 8 8 8 8 0 7 0 11 11 11 11 0 7 0 5 0 6 6 6 6 0 12 0 9 9 0 0 0 8 0 0 0 0 8 0 5 0 0 8 10 10 10 10 0 0 0 10 0 0 0 0 0 0 0 10 14 
14 0 0 0 0 0 11 0 8 8 8 8 0 7 0 11 11 11 11 0 7 0 5 0 0 0 0 0 0 12 0 9 0 0 5 0 5 5 5 8 0 0 0 5 0 8 8 0 10 0 0 0 10 0 10 0 10 0 10 0 10 0 0 14 
14 0 10 10 10 10 11 0 8 8 8 8 0 7 0 11 11 11 11 0 7 0 5 0 6 6 6 6 0 12 0 9 0 8 5 0 0 0 8 8 0 5 0 0 0 0 8 0 0 0 10 0 0 0 0 0 0 0 0 0 0 10 0 14 
14 0 0 0 0 0 11 11 0 0 0 0 0 7 0 0 0 0 0 0 7 0 11 0 0 0 6 0 0 12 0 9 0 0 5 8 0 0 0 0 0 5 0 5 8 0 8 0 8 8 8 8 8 8 8 8 8 8 8 8 0 0 0 14 
14 10 10 10 10 0 11 11 0 11 11 11 11 7 7 7 7 7 7 7 7 0 13 13 13 0 6 0 12 12 0 9 8 0 0 0 5 5 5 8 0 5 5 5 0 0 8 0 0 0 0 0 0 0 0 0 0 0 0 0 8 8 8 14 
14 0 0 0 0 0 0 0 0 10 0 0 0 0 0 0 0 0 0 0 0 0 0 0 13 0 6 0 12 0 0 9 0 0 0 8 0 0 0 0 0 8 0 5 8 0 8 0 8 8 8 8 8 8 8 8 8 8 8 0 0 0 0 14 
14 10 10 10 10 10 10 10 10 10 0 14 14 14 14 14 14 14 14 14 14 14 14 0 13 0 6 0 12 0 9 9 0 5 0 0 0 8 0 8 0 0 0 0 0 0 8 0 0 0 0 0 0 0 0 0 0 0 8 8 8 0 8 14 
14 0 0 0 0 0 0 0 0 0 0 0 14 14 0 0 0 0 0 0 0 0 0 0 13 0 6 0 12 0 9 0 0 5 0 5 5 5 0 5 0 8 0 5 0 8 8 0 8 8 8 8 8 8 8 8 8 0 0 8 0 0 0 14 
14 0 9 0 0 9 0 9 0 9 0 0 9 0 0 9 0 9 0 9 0 9 11 0 0 11 6 0 12 0 9 0 8 5 0 8 0 8 0 5 5 8 5 5 0 0 8 0 0 0 0 0 0 0 0 0 8 8 0 8 0 8 8 14 
14 0 9 0 0 9 0 9 0 9 0 9 9 0 9 9 0 9 0 9 0 9 11 11 0 13 0 0 12 0 9 9 0 5 0 0 0 0 0 5 0 8 0 5 8 0 8 0 8 8 8 8 8 8 8 0 0 8 0 8 0 0 8 14 
14 0 0 9 0 0 0 0 0 0 0 0 0 0 0 0 0 0 0 0 0 0 0 0 0 13 0 12 12 0 9 9 0 8 0 8 0 5 0 0 0 0 0 0 0 0 8 0 0 0 0 0 0 0 8 8 0 8 0 8 8 0 8 14 
14 0 10 10 10 10 10 10 10 10 10 10 10 10 10 10 10 10 10 10 10 10 10 11 0 13 0 0 12 0 9 0 0 8 0 0 0 5 8 0 8 8 8 5 8 0 8 0 8 8 8 8 8 0 0 8 0 8 0 8 8 0 8 14 
14 0 0 0 0 9 0 0 0 9 0 0 0 9 0 0 0 9 0 0 0 0 9 11 0 13 12 0 0 0 9 0 8 0 0 8 0 8 0 8 0 0 0 5 0 8 8 0 0 0 0 0 0 8 0 8 0 8 0 8 0 0 8 14 
14 0 0 9 0 9 0 9 0 9 0 9 0 9 0 9 0 9 0 9 0 0 0 0 0 13 12 12 12 0 0 0 0 8 0 0 0 0 0 8 0 5 0 5 0 0 8 0 8 8 8 8 0 8 0 8 0 8 0 8 0 8 8 14 
14 0 0 9 0 0 0 9 0 0 0 9 0 0 0 9 0 0 0 9 0 11 11 11 0 13 0 12 0 12 0 8 0 5 8 8 5 5 5 5 5 5 0 5 8 0 8 0 0 0 0 8 0 8 0 8 0 8 0 8 0 8 8 14 
14 0 11 11 11 11 11 11 11 11 11 11 11 11 11 11 11 11 11 11 11 11 11 11 0 13 0 12 0 12 0 0 5 0 0 0 0 0 0 0 0 5 0 0 0 0 8 0 8 8 0 8 0 8 0 8 0 8 0 8 0 8 8 14 
14 0 0 0 0 0 0 0 0 0 0 0 0 0 0 0 0 0 0 0 0 0 0 0 0 13 0 12 0 12 0 5 0 8 8 8 0 11 11 11 11 11 11 11 11 0 11 14 14 14 14 14 14 14 14 8 0 8 14 14 14 14 14 14 
14 0 0 1 0 1 0 1 0 1 0 1 0 1 0 1 0 1 0 1 0 1 0 1 0 13 0 0 0 12 0 0 0 0 0 0 0 11 0 11 0 11 0 11 0 0 11 14 14 14 14 14 14 14 14 8 0 8 14 14 14 14 14 14 
14 0 0 1 0 1 0 1 0 1 0 1 0 1 0 1 0 1 0 1 0 1 0 1 0 13 13 11 0 0 11 11 11 11 11 11 11 11 0 0 0 11 0 11 0 11 0 14 14 0 0 0 0 0 0 0 0 0 0 0 0 0 0 14 
14 0 0 0 0 0 0 0 0 0 0 0 0 0 0 0 0 0 0 0 0 0 0 0 0 0 13 11 11 0 11 0 0 0 0 11 0 0 0 1 0 0 0 11 0 0 0 14 14 0 0 0 0 0 0 0 0 0 0 0 0 0 0 14 
14 0 8 8 8 8 8 8 8 8 8 8 8 8 8 8 8 8 8 8 8 8 8 8 11 0 13 0 11 0 0 0 1 0 0 11 0 0 1 0 1 0 0 11 0 0 1 14 14 0 0 0 0 0 0 0 0 0 0 0 0 0 0 14 
14 0 0 0 0 0 0 0 0 0 0 0 0 0 0 0 0 0 0 0 0 0 0 0 11 0 13 0 11 0 0 1 0 1 0 0 0 1 0 0 0 1 0 0 0 1 0 14 14 0 0 0 0 0 0 0 0 0 0 0 0 0 0 14 
14 0 11 0 11 11 11 0 11 0 11 0 11 11 11 0 11 0 11 0 11 0 11 0 11 11 13 0 11 0 1 0 0 0 1 0 1 0 0 12 0 0 1 0 1 0 0 14 14 0 0 0 0 0 0 0 0 0 0 0 0 0 0 14 
14 0 11 0 11 0 11 11 11 0 11 11 11 0 11 0 11 0 11 0 11 0 11 0 0 0 13 0 11 1 0 0 12 0 0 1 0 0 12 0 12 0 0 1 0 0 12 14 14 0 0 0 0 0 0 0 0 0 0 0 0 0 0 14 
14 0 0 0 0 0 0 0 0 0 0 0 0 0 0 0 0 0 0 0 0 0 0 0 11 0 0 0 0 0 0 12 0 12 0 0 0 12 0 0 0 0 0 0 0 12 12 14 14 0 0 0 0 0 0 0 0 0 0 0 0 0 0 14 
14 14 14 14 14 14 14 14 14 14 14 14 14 14 14 14 14 14 14 14 14 14 14 14 14 14 14 14 14 14 14 14 14 14 14 14 14 14 14 14 14 14 14 14 14 14 14 14 14 14 14 14 14 14 14 14 14 14 14 14 14 14 14 14 
